PERISUR	Perisur
GALERIAS PERINORTE	Galer眼s Perinorte
GALER페S PERINORTE	Galer眼s Perinorte
GALERIAS TABASCO	Galer眼s Tabasco
GALER페S TABASCO	Galer眼s Tabasco
GALERIAS MONTERREY	Galer眼s Monterrey
GALER페S MONTERREY	Galer眼s Monterrey
GALERIAS COAPA	Galer眼s Coapa
GALER페S COAPA	Galer眼s Coapa
GALERIAS LAGUNA	Galer眼s Laguna
GALER페S LAGUNA	Galer眼s Laguna
GALERIAS SALTILLO	Galer眼s Saltillo
GALER페S SALTILLO	Galer眼s Saltillo
GALERIAS CHILPANCINGO	Galer眼s Chilpancingo
GALER페S CHILPANCINGO	Galer眼s Chilpancingo
GALERIAS ATIZAPAN	Galer眼s Atizap烱
GALER페S ATIZAPAN	Galer眼s Atizap烱
GALERIAS ATIZAP쳁	Galer眼s Atizap烱
GALER페S ATIZAP쳁	Galer眼s Atizap烱
GALERIAS VALLARTA	Galer眼s Vallarta
GALER페S VALLARTA	Galer眼s Vallarta
GALERIAS MERIDA	Galer眼s M本ida
GALER페S MERIDA	Galer眼s M本ida
GALERIAS MRIDA	Galer眼s M本ida
GALER페S MRIDA	Galer眼s M本ida
GALERIAS CUERNAVACA	Galer眼s Cuernavaca
GALER페S CUERNAVACA	Galer眼s Cuernavaca
GALERIAS QUERETARO	Galer眼s Queretaro
GALER페S QUERETARO	Galer眼s Queretaro
GALERIAS METEPEC	Galer眼s Metepec
GALER페S METEPEC	Galer眼s Metepec
GALERIAS INSURGENTES	Galer眼s Insurgentes
GALER페S INSURGENTES	Galer眼s Insurgentes
GALERIAS CELAYA	Galer眼s Celaya
GALER페S CELAYA	Galer眼s Celaya
GALERIAS ZACATECAS	Galer眼s Zacatecas
GALER페S ZACATECAS	Galer眼s Zacatecas
GALERIAS SAN JUAN DEL RIO	Galer眼s San Juan del R癌
GALER페S SAN JUAN DEL RIO	Galer眼s San Juan del R癌
GALERIAS SAN JUAN DEL R펦	Galer眼s San Juan del R癌
GALER페S SAN JUAN DEL R펦	Galer眼s San Juan del R癌
GALERIAS CAMPECHE	Galer眼s Campeche
GALER페S CAMPECHE	Galer眼s Campeche
GALERIAS MAZATLAN	Galer眼s Mazatl烱
GALER페S MAZATLAN	Galer眼s Mazatl烱
GALERIAS MAZATL쳁	Galer眼s Mazatl烱
GALER페S MAZATL쳁	Galer眼s Mazatl烱
GALERIAS ACAPULCO	Galer眼s Acapulco
GALER페S ACAPULCO	Galer眼s Acapulco
GALERIAS SERDAN	Galer眼s Serd烱
GALER페S SERDAN	Galer眼s Serd烱
GALERIAS SERD쳁	Galer眼s Serd烱
GALER페S SERD쳁	Galer眼s Serd烱
GALERIAS TOLUCA	Galer眼s Toluca
GALER페S TOLUCA	Galer眼s Toluca
